R 1000 1000

NO 255,0,0

SO 255,0,0

WE 255,0,0

EA 255,0,0

S 255,0,0

F 220,100,0

C 225,30,0

1111
1001
10N1
1111