R 1000 1000

NO 255,0,0

SO 255,255,0

WE 255,20,147

EA 0,191,255

S 255,0,0

F 220,100,0

C 225,30,0

1111111111111
1000000000001
1000000000001
100000N000001
1000000000001
1000000000001
1111111111111