R 800 800

R 800 800

NO ./textures/blue.xpm

SO ./textures/brick.xpm

WE ./textures/wood.xpm

EA ./textures/eagle.xpm

S ./textures/barrel.xpm

F 0,0,0

C 128,128,128

        1111111111111111111111111
        1000000000110000000000001
        1011000001110000001000001
        1001000000000000000000001
111111111011000001110000000000001
100000000011000001110100111111111
10000000000000000000000000001
10000000000000000000000000001
10000001100000000000011000001
10000001100000000000011000001
10000000000000000000000000001
10000000000000000000000000001
10000000000000000000000000001
11110111111111011100000010001
11110111111111011101010010001
11000000110101011100000010001
10001000000000000000000000001
10000000000000000001010000001
11000001110101011111011110N0111
11110111 1110101 101111010001
11111111 1111111 111111111111