NO   ./textures/eagle.xpm
SO ./textures/eagle.xpm

WE    ./textures/wood.xpm

S ./textures/barrel.xpm

EA ./textures/eagle.xpm

C 30,30,30

F 0,0,0

111111
100N11
111111