  NO     ./textures/eagle.xpm

SO ./textures/eagle.xpm

WE    ./textures/wood.xpm

S ./textures/barrel.xpm

EA ./textures/eagle.xpm

C 30,30,30

F 0,0,0

        1111111111111111111111111
        1000000000110000000000001
        1011000001110000001000001
        1001000000000000000000001
111111111011000001110000000000001
100000000011000001110100111111111
10000000000000000000000000001
10000000000000000000000000001
1000000110000000000011000001
10000001100000002000011000001
10000000000000000000000000001
10000000000200000200000000001
10000000000000000000000000001
11110111111111011100000010001
11110111111111011101010010001
11000000110101011100000010001
10001000000000000000000000001
10000000000000000001010000101
11000001110101011111011110001
11110111 1110101 101111010N01
11111111 1111111 111111111111