NO ./textures/blue.xpm

SO ./textures/brick.xpm

WE ./textures/wood.xpm

EA ./textures/eagle.xpm

S ./textures/barrel.xpm

C 128,128,128

F 0,0,0

        1111111111111111111111111
        1000000000110000000000001
        1011000001110000001000001
        1001000000000000000000001
111111111011000001110000000000001
100000000011000001110100111111111
10000000000000000000000000001
10000000000000000000000000001
1000000110000202000011000001
10000001100000000000011000001
1002000000000N000000000000001
10000020000000000000000000001
10000000000000002000000000001
11110111111111011100000010001
11110111111111011101010010001
11000000110101011100000010001
10001000000000000000000000001
10000000000000000001010000001
11000001110101011111011110011
11110111 1110101 101111010001
11111111 1111111 111111111111